address	adresse
again	de nouveau
against	contre
airplane	avion
all	tout
almost	presque
alongside	le long de
also	aussi
although	bien que
always	toujours
among	entre
amuse	amuser
arrive	arriver
aunt	tante
author	auteur
bacon	lard
baggage	bagage
bake	cuire
between	entre
blind	aveugle
blue	bleu
boring	ennuyeux
both	tous les deux
by chance	par accident
by heart	par coeur
